0 1 1 1 1 1 1 1 1 1 
0 0 1 1 1 1 1 1 1 1 
1 0 0 1 1 1 1 1 1 1 
1 1 0 0 1 1 1 1 1 1 
1 1 1 0 0 1 1 1 1 1 
1 1 1 1 0 0 1 1 1 1 
1 1 1 1 1 0 0 1 1 1 
1 1 1 1 1 1 0 0 1 1 
1 1 1 1 1 1 1 0 0 1 
1 1 1 1 1 1 1 1 0 0 
Tem caminho
Caminho percorrido: [s ,d ,s ,d ,s ,d ,s ,d ,s ,d ,s ,d ,s ,d ,s ,d ,s ,d]

0 0 0 0 0 0 0 0 0 0 
1 1 1 1 1 1 1 1 1 0 
1 1 1 1 1 1 1 1 1 0 
1 1 1 1 1 1 1 1 1 0 
1 1 1 1 1 1 1 1 1 0 
1 1 1 1 1 1 1 1 1 0 
1 1 1 1 1 1 1 1 1 0 
1 1 1 1 1 1 1 1 1 0 
1 1 1 1 1 1 1 1 1 0 
1 1 1 1 1 1 1 1 1 0 
Tem caminho
Caminho percorrido: [d ,d ,d ,d ,d ,d ,d ,d ,d ,s ,s ,s ,s ,s ,s ,s ,s ,s]

0 0 0 0 0 0 0 0 0 0 
0 0 0 0 0 0 0 0 0 0 
0 0 0 0 0 0 0 0 0 0 
0 0 0 0 0 0 0 0 0 0 
0 0 0 0 0 0 0 0 0 0 
0 0 0 0 0 0 0 0 0 0 
0 0 0 0 0 0 0 0 0 0 
0 0 0 0 0 0 0 0 0 0 
0 0 0 0 0 0 0 0 0 0 
0 0 0 0 0 0 0 0 0 0 
Tem caminho
Caminho percorrido: [s ,s ,s ,s ,s ,s ,s ,s ,s ,d ,d ,d ,d ,d ,d ,d ,d ,d]

0 1 1 1 1 1 1 1 1 1 
0 0 1 1 1 1 1 1 1 1 
1 0 0 1 1 1 1 1 1 1 
1 1 0 0 1 1 1 1 1 1 
1 1 1 0 0 1 1 1 1 1 
1 1 1 1 0 0 1 1 1 1 
1 1 1 1 1 0 0 1 1 1 
1 1 1 1 1 1 0 0 1 1 
1 1 1 1 1 1 1 0 0 1 
1 1 1 1 1 1 1 1 1 0 
Sem caminho
Caminho percorrido: []
